%%%%%%%%%%%%%%%%%%%%%%%%%%%%
%oooooooooooooooooooooooooo%
%.oooooooooooooooooooooooo.%
%o%%%%.%%%%%G%%.%%%%%.%%%%o%
%oooooooooooooooooooooooooo%
%o.o..o...o..oG..o..o..o.o.%
%.oooooooooooooooooooooooo.%
%.oooooooooooooooooooooooo.%
%oooooooooooooooooooooooooo%
%oooooooooooooooooooooooooo%
%.oooo.o.o..o.P..oo.o..o.o.%
%%%%%%%%%%%%%%%%%%%%%%%%%%%%